111111111111111111111111111111111111111111111111111111111111111111
1E0000000000000C00000C00010010100100000101001000000010100000000001
101001010010000010100100100101001000001010010000000101000000010101
101001010010000010100100000001001010010000010100100000001010010101
101001010010000010100101001010010000010100100000001010000000010101
101001010010000010100100000000100101001000001010010000000101010101
101001010010000010100100000100101001000001010010000000101000010101
101001010010000010100100000100101001000001010010000000101000010101
101001010010000010100100010010100100000101001000000010100000010101
101001010010000010100100000001010010010100100000101001000000010101
101001010010000010100100000001001001010010000010100100000001010101
101001010010000010100100000001010010010100100000101001000000010101
101001010010000010100100000001010010010100100000101001000000010101
101001001010101000100100000010010100100000101001000000010100010101
101001001010101000100100000010010100100000101001000000010100010101
101001001010101000100100000010010100100000101001000000010100010101
101001001010101000100100000010010100100000101001000000010100010101
101001001010101000100100000010010100100000101001000000010100010101
101001001010101000100100000010010100100000101001000000010100010101
101001001010101000100100000010010100100000101001000000010100010101
101001001010101000100100000010010100100000101001000000010100010101
101001001010101000100100000010010100100000101001000000010100010101
101001001010101000100100000010010100100000101001000000010100010101
101001001010101000100100000010010100100000101001000000010100010101
101001001010101000100100000010010100100000101001000000010100010101
101001001010101000100100000010010100100000101001000000010100010101
101001001010101000100100000010010100100000101001000000010100010101
101001001010101000100100000010010100100000101001000000010100010101
101001001010101000100100000010010100100000101001000000010100010101
101001001010101000100100000010010100100000101001000000010100010101
101001001010101000100100000010010100100000101001000000010100010101
101001001010101000100100000010010100100000101001000000010100010101
101001001010101000100100000010010100100000101001000000010100010101
101001001010101000100100000010010100100000101001000000010100010101
101001001010101000100100000010010100100000101001000000010100010101
101001001010101000100100000010010100100000101001000000010100010101
101001001010101000100100000010010100100000101001000000010100010101
1P0000000C00C00000000000000000000000000000000000000000000000000001
111111111111111111111111111111111111111111111111111111111111111111
